.--------D--
           -
S--- ----- -
   E-X   E--
S--- -- --  
      E-X   
------- ----
           -
 YYYYYYYY---