---------D--
           -
S--- ----- -
   #-#   #--
S--- -- --  
      #-#   
S------ ----
           -
 YYYYYYYY---