------------
           -
S--- ----- -
   #-#   #--
S--- -   - 
      #-#
S------ ----
 -----------